3 5
2
4 7
3 2
##########
#        #
#        #
# O  @   #
#      O #
#        #
#      x #
#        #
#    x   #
##########
