5 5
2
6 7
3 2
10 10
##########
#        #
#        #
# O      #
#        #
#    @   #
#      O #
#        #
#    x   #
##########
